500 14
1 1 1 1 1 1 1 1 1 1 1 1 1 1 1 1 1 1 1 1 1 1 1 1 1 1 1 1 1 1 1 1 1 1 1 1 1 1 1 1 1 1 1 1 1 1 1 1 1 1 1 1 1 1 1 1 1 1 1 1 1 1 1 1 1 1 1 1 1 1 1 1 1 1 1 1 1 1 1 1 1 1 1 1 1 1 1 1 1 1 1 1 1 1 1 1 1 1 1 1 1 1 1 1 1 1 1 1 1 1 1 1 1 1 1 1 1 1 1 1 1 1 1 1 1 1 1 1 1 1 1 1 1 1 1 1 1 1 1 1 1 1 1 1 1 1 1 1 1 1 1 1 1 1 1 1 1 1 1 1 1 1 1 1 1 1 1 1 1 1 1 1 1 1 1 1 1 1 1 1 1 1 1 1 1 1 1 1 1 1 1 1 1 1 1 1 1 1 1 1 1 1 1 1 1 1 1 1 1 1 1 1 1 1 1 1 1 1 1 1 1 1 1 1 1 1 1 1 1 1 1 1 1 1 1 1 1 1 1 1 1 16 16 16 16 16 16 16 16 16 26 26 26 26 26 26 26 26 26 26 26 26 26 26 26 26 26 26 26 26 26 26 26 26 26 26 26 26 26 26 26 26 26 26 26 26 26 26 26 26 26 26 26 26 26 26 26 26 26 26 26 26 26 26 26 26 26 26 26 26 26 26 26 26 26 26 26 26 26 26 26 26 26 26 26 26 26 26 26 26 26 26 26 26 26 26 26 26 26 26 26 26 26 26 26 26 26 26 26 26 26 26 26 26 26 26 26 26 26 26 26 26 26 26 26 26 26 26 26 26 26 26 26 26 26 26 26 26 26 26 26 26 26 26 26 26 26 26 26 26 26 26 26 26 26 26 26 26 26 26 26 26 26 26 26 26 26 26 26 26 26 26 26 26 26 26 26 26 26 26 26 26 26 26 26 26 26 26 26 26 26 26 26 26 26 26 26 26 26 26 26 26 26 26 26 26 26 26 26 26 26 26 26 26 26 37 37 37 37 37 37 37 37 37 37 37 37 37 37 37 37 37 37 37 37 37 37 37 37 37 37 37 37 37 37 37 37 37 37 37 37 37 37 37 37 37 37 37 37 37
1 1 1 1 1 1 1 1 1 1 1 1 1 1 1 1 1 1 1 1 1 1 1 1 1 1 1 1 1 1 1 1 1 1 1 1 1 1 1 1 1 1 1 1 1 1 1 1 1 1 1 1 1 1 1 1 1 1 1 1 1 1 1 1 1 1 1 1 1 1 1 1 1 1 1 1 1 1 1 1 1 1 1 1 1 1 1 1 1 1 1 1 1 1 1 1 1 1 1 16 1 1 1 1 1 16 1 9 1 1 1 1 1 1 1 1 1 1 1 1 1 1 1 1 1 1 1 1 1 1 1 1 1 1 1 1 1 1 1 1 1 1 1 1 1 1 1 1 1 1 1 1 1 1 1 1 1 1 1 1 1 1 1 1 1 1 1 1 1 1 1 1 1 1 1 1 1 1 1 1 1 1 1 1 1 1 1 1 1 1 1 1 1 1 1 1 1 1 1 1 1 1 1 1 1 1 1 1 1 1 1 1 1 1 1 1 1 1 1 1 1 1 1 1 1 1 1 1 1 1 1 1 1 1 1 1 1 1 1 1 1 1 1 16 16 16 16 16 16 16 26 26 26 26 26 26 26 26 26 26 26 27 27 13 26 26 26 26 26 26 27 13 26 26 27 27 13 13 27 26 13 27 27 13 13 13 27 26 26 26 26 26 26 26 26 26 26 26 26 26 26 26 26 26 26 26 26 13 13 27 13 13 27 27 13 13 27 27 27 13 27 27 13 13 13 13 13 13 27 27 27 27 27 27 27 27 27 27 13 13 13 13 13 13 13 13 13 13 13 27 13 13 13 13 27 13 26 26 26 26 26 26 27 27 13 13 27 26 26 26 26 27 27 26 26 26 26 26 26 26 27 27 13 26 26 26 26 26 26 26 26 26 26 26 26 26 26 26 26 26 26 26 26 26 26 26 26 26 26 26 26 26 26 27 13 13 26 26 26 26 26 13 27 26 26 26 26 26 26 26 26 26 26 26 26 26 26 26 27 13 26 26 27 26 26 26 26 26 26 26 26 26 26 26 26 37 37 37 37 37 37 37 37 38 29 29 38 38 29 29 29 29 38 38 29 29 29 38 29 29 38 29 29 29 38 37 37 37 37 37 37 37 37 37 37 37 37 37 37 37
1 1 1 1 1 1 1 1 1 1 1 1 1 1 1 1 1 1 1 8 8 8 1 1 1 1 1 1 1 1 1 1 1 1 1 1 1 1 1 1 1 1 1 1 1 1 1 1 1 1 1 1 1 1 1 1 1 1 1 1 1 1 1 1 1 1 1 1 1 1 1 1 1 1 1 1 1 1 1 1 1 1 1 1 1 1 1 1 1 1 1 1 1 1 1 1 1 1 16 16 1 1 9 1 16 16 16 16 1 1 1 9 1 1 16 16 1 9 1 1 1 1 1 1 1 1 1 1 1 1 1 1 1 1 1 1 1 1 1 1 1 1 1 1 1 1 1 1 1 1 1 1 1 1 1 1 1 1 1 1 1 1 1 1 1 1 1 1 1 1 1 1 1 1 1 1 1 1 1 1 1 1 1 1 1 1 1 1 1 1 1 1 1 1 1 1 1 1 1 1 1 1 1 1 1 1 1 1 1 1 1 1 1 8 8 8 8 1 1 1 1 1 1 1 1 1 1 1 1 1 8 1 1 1 1 1 1 1 1 1 1 1 1 1 1 1 1 16 16 16 26 26 26 26 26 26 26 26 26 26 13 13 13 13 27 26 26 26 27 13 13 13 26 26 13 13 13 13 13 27 13 13 13 13 13 13 13 13 26 26 26 26 26 26 26 26 26 26 26 26 26 26 26 26 26 27 27 13 13 13 13 13 13 13 13 13 13 13 13 13 13 13 13 13 13 13 13 13 13 13 13 13 13 13 13 13 13 13 13 13 13 13 13 13 13 13 13 13 13 13 13 13 13 13 13 13 13 26 26 26 26 27 13 13 13 13 13 27 26 13 13 13 13 26 26 26 26 26 27 13 13 13 13 26 26 26 27 13 27 27 13 26 26 26 26 26 27 27 27 27 27 13 13 13 13 27 13 27 13 13 27 27 13 13 13 13 13 27 27 26 26 13 13 13 13 27 13 27 27 26 26 27 26 26 26 26 26 27 13 13 26 26 13 13 13 27 27 27 26 26 26 26 27 26 26 29 37 37 37 37 38 29 29 38 29 29 38 39 29 29 29 29 39 38 29 29 29 29 29 29 38 29 29 29 38 29 29 37 29 29 38 29 38 29 38 29 29 29 29 37
1 3 1 1 1 1 1 1 1 1 1 1 1 1 1 1 1 1 8 8 8 8 8 1 1 1 1 1 1 1 1 1 1 1 1 1 1 1 1 1 1 1 1 1 1 1 1 1 1 1 1 1 1 1 1 1 1 1 1 1 1 1 1 1 1 1 1 1 1 1 1 1 1 1 1 1 1 1 1 1 1 1 1 1 1 1 1 1 1 1 1 1 1 1 1 1 1 1 1 16 16 16 16 16 16 16 16 16 16 16 16 16 16 16 16 16 16 16 1 1 1 9 1 1 1 1 1 1 1 1 1 8 8 1 1 1 1 1 1 1 1 1 1 1 1 1 1 1 1 1 1 1 1 1 1 1 1 1 1 1 1 1 1 1 1 1 1 1 1 1 1 1 1 1 1 1 1 1 1 8 1 1 1 1 1 1 1 1 1 1 1 1 1 1 1 1 1 1 1 1 1 1 8 1 1 1 1 1 1 1 1 1 8 8 8 8 8 8 1 1 1 1 1 1 1 1 1 1 1 8 8 8 1 1 1 1 1 1 1 1 1 1 1 1 1 1 1 1 16 16 26 26 26 26 27 27 13 13 26 27 13 13 13 13 13 13 13 26 13 13 13 13 26 27 13 13 13 13 13 13 13 13 13 13 13 13 13 13 27 26 26 26 26 26 26 26 26 26 26 26 26 26 26 27 27 13 13 13 13 13 13 13 13 13 13 13 13 13 13 13 13 13 13 13 13 13 13 13 13 13 13 13 13 13 13 13 13 13 13 13 13 13 13 13 13 13 13 13 13 13 13 13 13 13 13 13 13 27 26 26 13 13 13 13 13 13 13 13 27 13 13 13 13 27 26 13 13 27 13 13 13 13 13 27 26 26 13 13 13 13 13 26 27 27 27 13 13 13 13 13 13 13 13 13 13 13 13 13 13 13 13 13 13 13 13 13 13 13 13 13 27 13 13 13 13 13 13 13 13 26 27 13 26 26 13 27 13 13 13 13 26 27 13 13 13 13 13 13 27 26 26 26 13 26 26 29 29 29 29 29 38 29 29 29 29 29 38 29 29 29 29 29 29 38 29 29 29 29 29 29 29 29 29 29 38 29 29 38 29 29 38 29 38 29 38 29 29 29 29 29
1 1 1 1 1 1 1 1 1 1 1 1 1 1 1 1 1 1 8 8 8 8 8 1 1 1 1 1 1 1 1 1 1 1 1 1 1 1 1 1 1 1 1 1 1 1 1 1 1 1 1 1 1 1 1 1 1 1 1 1 1 1 1 1 1 1 1 1 1 1 1 1 1 1 1 1 1 1 1 1 1 1 1 1 1 1 1 1 1 1 1 1 1 1 1 1 1 1 1 16 16 16 16 16 16 16 16 16 16 16 16 16 16 16 16 16 16 16 16 16 16 16 1 1 1 1 1 1 1 1 8 8 8 8 1 1 1 1 1 1 1 1 1 1 1 1 1 1 1 1 1 1 1 1 1 1 1 1 1 1 1 1 1 1 1 1 1 1 1 1 1 1 1 1 1 1 1 1 8 8 8 1 1 1 1 1 1 1 1 1 1 1 1 1 1 1 1 1 1 1 1 8 8 8 1 1 1 1 1 1 1 1 8 8 8 8 8 8 1 1 1 1 1 1 1 1 1 1 1 5 7 1 1 1 1 1 1 1 1 1 1 1 1 1 1 1 1 1 1 16 26 26 26 13 13 13 13 13 26 13 13 13 13 13 13 13 13 27 13 13 13 13 27 13 13 13 13 13 25 26 13 13 13 13 13 13 13 13 13 26 26 26 26 26 26 26 26 26 26 26 26 26 26 13 13 13 13 13 13 13 13 13 13 13 13 13 13 13 13 13 13 13 13 13 13 13 13 13 13 13 13 13 13 13 13 13 13 13 13 13 13 13 13 13 13 13 13 13 13 13 13 13 13 13 13 13 13 13 13 26 13 13 13 13 13 13 13 13 13 13 13 13 13 13 13 13 13 13 13 13 13 13 13 13 26 13 13 13 13 13 13 27 13 13 13 13 13 13 13 13 13 13 13 13 13 13 13 13 13 13 13 13 13 13 13 13 13 13 13 13 13 13 13 13 13 13 13 13 13 13 13 13 27 13 13 13 13 13 13 13 27 13 13 13 13 13 13 13 13 26 13 13 13 26 13 29 29 29 29 29 39 29 29 29 29 29 39 29 29 29 29 29 29 39 29 29 29 29 29 29 29 29 29 29 29 29 29 38 29 29 29 29 38 29 38 29 29 29 29 29
1 1 1 1 1 1 1 1 1 1 1 1 1 1 1 1 1 1 1 1 7 1 1 1 1 1 1 1 1 1 1 1 1 1 1 1 1 1 1 1 1 1 1 1 1 1 1 1 1 1 1 1 1 8 1 1 1 1 1 1 8 1 1 1 1 1 1 1 1 1 1 1 1 1 16 1 1 1 1 1 1 1 1 1 1 1 1 1 1 1 1 1 1 1 1 1 1 1 1 16 16 16 16 16 16 16 16 16 16 16 16 16 16 16 16 16 16 16 16 16 16 16 1 1 1 1 1 1 1 8 8 8 8 8 8 1 1 1 1 1 1 1 1 1 1 1 1 1 1 1 17 0 1 1 1 1 1 1 1 1 1 1 1 1 1 1 1 1 1 1 0 18 1 1 1 1 1 8 8 8 8 8 1 1 1 1 1 1 1 1 1 10 1 1 1 1 1 1 1 1 1 8 8 8 1 1 1 1 1 1 1 1 1 4 7 7 4 1 1 1 1 1 10 1 1 1 1 1 1 1 4 6 1 1 1 1 1 1 1 1 1 1 1 1 1 1 1 1 1 16 26 26 27 13 13 13 13 13 27 13 13 13 13 13 13 13 13 13 13 13 13 13 13 13 13 13 13 13 26 26 13 13 13 13 13 13 13 13 13 26 26 26 26 26 27 26 26 26 26 26 26 26 26 13 13 13 13 13 13 13 25 26 13 28 13 13 13 13 13 28 13 13 13 13 13 13 13 13 13 13 13 28 13 13 13 28 13 13 13 13 28 13 13 13 28 13 13 13 13 13 13 13 13 13 13 13 13 13 13 27 13 13 13 13 13 13 13 13 13 13 13 13 13 13 13 13 13 13 13 13 13 13 13 13 27 13 13 13 13 13 13 13 13 13 13 13 13 13 13 13 13 13 13 13 13 13 13 13 13 13 13 13 13 13 13 13 13 13 13 13 13 13 13 13 13 13 13 13 13 13 13 13 13 13 13 13 13 13 13 13 13 13 13 13 13 13 13 13 13 27 13 13 13 26 13 29 29 29 29 29 29 29 29 29 29 29 29 29 29 29 29 29 29 29 29 29 29 29 29 29 29 29 29 29 29 29 29 39 29 29 29 29 38 29 38 29 29 29 29 29
1 1 1 1 1 1 1 1 1 1 1 1 1 1 1 1 1 5 11 11 4 1 1 1 1 1 1 1 1 1 1 1 1 1 1 1 1 1 10 1 1 1 1 8 1 1 1 1 1 1 1 1 8 8 8 1 1 1 1 8 8 8 1 1 1 1 1 1 1 1 1 1 1 1 16 1 1 1 1 1 1 1 1 1 1 1 1 1 10 1 1 1 1 1 1 1 8 1 1 1 1 16 16 16 16 16 16 16 16 16 16 16 16 16 16 16 16 16 16 16 16 16 1 1 1 1 1 1 1 1 1 7 7 1 1 1 1 1 1 1 1 1 1 1 1 1 1 1 1 17 2 2 14 14 14 14 14 14 14 14 14 14 14 14 14 14 14 14 14 14 2 2 18 1 1 1 1 8 8 8 8 8 1 1 1 1 17 18 1 1 17 0 18 1 1 17 18 1 1 1 1 5 7 1 1 1 1 1 1 1 5 5 5 7 7 4 7 6 1 1 1 1 16 16 1 1 1 1 16 16 7 1 1 10 1 1 1 1 1 1 1 1 1 1 1 1 1 1 1 16 26 13 13 13 13 13 13 13 13 13 13 13 13 13 13 13 13 13 13 13 13 28 13 25 13 13 13 13 26 26 28 13 13 13 13 13 13 13 13 27 26 27 26 27 13 13 13 27 27 26 26 26 27 13 13 13 13 13 13 26 26 26 26 26 26 26 26 26 26 26 26 26 26 26 26 26 26 13 13 13 13 26 26 26 26 26 13 13 13 13 26 26 26 26 26 13 13 13 13 13 13 13 13 13 13 13 13 13 13 13 13 13 13 13 13 13 13 13 13 13 13 13 13 13 13 13 13 13 26 13 13 13 13 13 13 13 13 13 13 13 13 13 13 13 13 13 13 13 13 13 28 13 13 13 25 13 13 13 28 13 13 13 13 13 13 13 13 13 13 13 13 13 13 13 13 13 13 13 26 13 13 13 13 13 13 13 13 13 13 13 13 13 13 13 13 13 13 13 13 13 13 13 13 27 13 29 29 29 29 29 29 29 29 29 29 29 29 29 29 29 29 29 29 29 29 29 29 29 35 29 29 35 29 29 29 29 29 29 29 29 29 29 38 29 39 29 29 29 29 29
1 1 1 1 1 1 8 1 1 1 1 1 1 1 1 1 1 1 1 1 7 11 6 1 1 1 1 1 1 1 1 1 1 1 1 1 1 5 7 1 1 1 8 8 8 1 1 1 1 1 1 1 8 8 8 1 1 1 1 8 8 8 1 1 1 1 1 1 1 1 1 1 1 5 16 1 11 11 1 1 11 11 11 1 1 11 11 1 16 1 1 1 1 1 1 8 8 8 1 1 1 1 16 1 1 1 1 1 1 1 1 1 16 1 1 1 1 1 1 1 1 1 1 1 1 1 1 1 1 1 1 4 7 6 6 6 1 1 1 1 1 1 1 1 1 1 1 1 17 2 2 2 15 15 15 15 15 15 15 15 15 15 15 15 15 15 15 15 15 15 2 2 2 18 1 1 1 1 1 4 1 1 1 1 1 17 2 2 14 14 2 2 2 14 14 2 2 18 1 1 1 1 4 6 1 1 1 1 1 1 1 1 1 4 7 4 7 1 1 1 1 1 16 16 14 14 14 16 16 16 16 16 16 16 1 1 1 1 1 1 1 1 1 1 1 1 1 1 1 27 27 13 13 13 13 13 13 13 13 13 13 13 13 23 24 13 13 13 13 13 23 21 21 21 21 21 24 26 26 26 26 23 24 13 13 13 13 13 13 13 27 13 13 13 13 13 13 13 13 27 13 13 13 13 13 13 13 26 26 26 26 26 26 27 27 27 26 26 26 26 27 26 26 26 26 26 13 13 13 13 13 27 26 26 26 27 13 13 13 13 27 26 26 26 27 13 13 13 13 13 13 13 13 13 13 13 13 13 13 13 13 13 13 13 25 13 13 13 13 13 13 13 13 13 23 26 26 26 26 28 13 25 13 13 13 13 13 28 13 13 13 13 13 13 13 13 13 13 25 26 26 26 26 26 26 26 26 26 26 26 28 13 13 13 13 13 13 13 13 13 13 13 13 13 13 13 13 13 26 13 13 13 13 13 13 13 13 13 13 13 13 13 13 13 13 13 13 13 13 13 13 13 13 13 13 29 29 29 29 29 29 29 29 29 29 29 29 29 29 32 33 33 33 31 29 29 29 29 30 29 29 30 29 29 29 29 29 29 29 29 29 29 38 29 29 29 29 29 29 29
1 1 1 1 1 8 8 8 1 1 1 1 1 1 1 1 1 1 1 1 7 1 1 1 1 1 1 1 1 1 1 1 1 1 1 1 1 1 4 6 1 8 8 8 8 8 1 1 1 1 1 1 1 7 1 1 1 1 1 1 7 1 1 1 1 1 1 1 1 1 9 1 1 1 16 1 1 1 1 1 1 1 1 1 1 1 1 1 16 1 1 1 1 1 1 8 8 8 1 1 1 1 1 1 1 1 1 1 1 1 1 1 1 1 1 1 1 1 1 1 1 1 1 1 1 1 1 1 5 5 5 7 7 1 1 1 1 1 1 1 1 1 1 1 1 1 1 17 2 2 2 2 15 15 15 15 15 15 15 15 15 15 15 15 15 15 15 15 15 15 2 2 2 2 18 1 1 1 5 7 6 1 1 1 17 2 2 2 15 15 2 2 2 15 15 2 2 2 18 1 10 1 7 1 1 1 1 1 1 1 1 1 5 7 4 7 4 6 6 1 1 16 16 16 15 15 16 16 16 16 16 16 16 16 16 16 16 16 1 1 1 1 1 1 1 1 1 1 1 13 13 13 13 13 13 13 25 13 13 13 13 13 23 22 22 24 13 25 13 23 22 22 22 22 22 22 22 21 21 21 21 22 22 24 13 13 13 13 13 13 13 13 13 13 13 13 13 13 13 13 13 13 13 13 13 23 21 21 21 21 21 21 21 24 13 13 26 26 27 13 13 26 26 26 27 27 13 13 13 13 13 13 26 26 26 13 13 13 13 13 13 26 26 26 13 13 13 13 13 26 26 26 13 13 13 13 13 13 13 13 13 13 13 13 26 13 13 13 13 13 13 13 13 23 22 26 26 26 26 26 26 26 13 13 26 26 26 26 26 28 13 25 13 13 13 13 28 26 26 26 26 26 26 26 26 26 26 26 26 26 26 26 26 25 13 13 13 13 13 13 13 13 13 13 13 13 13 13 26 13 13 13 13 13 13 13 13 13 13 13 13 13 13 13 13 13 13 13 13 13 13 13 13 13 13 29 29 29 29 29 29 29 29 29 29 29 32 33 33 34 34 34 34 34 33 33 33 33 37 36 36 37 33 33 33 31 29 29 29 29 29 29 39 29 29 29 29 29 29 29
1 1 1 1 1 8 8 8 1 1 1 1 1 1 1 1 1 9 1 10 7 10 1 1 1 1 1 1 1 1 1 1 1 1 1 1 5 5 7 1 1 1 1 7 1 1 1 1 1 1 1 1 1 4 11 11 11 11 11 11 4 1 1 1 1 1 1 1 16 1 16 1 1 1 16 14 14 14 14 14 14 14 14 14 14 14 14 14 16 6 1 1 11 11 1 1 7 1 1 1 1 1 1 1 1 1 1 1 1 10 1 1 11 11 1 1 9 1 1 1 1 1 1 1 1 1 1 1 1 1 1 7 4 1 1 1 1 1 1 1 1 1 1 1 1 1 17 2 2 2 2 2 15 15 15 15 15 15 15 15 15 15 15 15 15 15 15 15 15 15 2 2 2 2 2 18 1 10 1 7 1 9 1 17 2 2 2 2 15 15 2 2 2 15 15 2 2 2 2 0 0 0 0 0 18 1 1 1 1 1 9 1 1 4 7 7 4 1 1 1 16 16 16 16 16 16 16 16 16 16 16 16 16 16 16 16 16 16 16 1 1 1 1 1 1 1 1 1 1 13 13 13 13 13 13 26 26 13 13 13 13 23 22 22 22 22 21 21 21 22 22 22 22 22 22 22 22 22 22 22 22 22 22 22 24 13 13 13 23 26 25 13 13 13 13 13 13 13 13 13 13 13 13 25 23 22 22 22 22 22 22 22 22 22 24 13 26 27 13 13 13 27 26 26 13 13 13 13 13 13 13 13 27 26 27 13 13 13 13 13 13 27 26 27 13 13 13 13 13 27 26 27 13 13 13 13 13 13 13 13 13 13 13 28 26 26 13 13 13 13 13 13 23 22 22 26 26 26 26 26 26 26 15 15 26 26 26 26 26 26 26 26 26 26 26 26 26 26 26 26 26 26 26 26 26 26 26 26 26 26 26 26 26 26 24 13 13 13 13 13 13 13 13 13 26 13 13 13 26 13 13 13 13 13 13 13 13 13 13 13 13 13 13 13 13 13 13 13 13 13 13 13 13 13 13 29 29 29 35 29 29 29 35 29 29 32 34 34 34 34 34 34 34 34 34 34 34 34 37 36 36 37 34 34 34 34 31 35 29 29 29 29 29 29 29 29 29 29 29 35
1 1 1 1 1 1 7 1 1 1 1 1 1 1 19 20 0 0 0 0 0 0 0 18 1 1 1 1 1 1 1 1 17 0 18 1 1 1 7 6 6 1 1 4 6 1 1 1 1 1 17 18 10 7 1 10 1 1 10 1 7 10 1 1 1 1 1 5 16 1 16 1 5 16 16 15 15 15 15 15 15 15 15 15 15 15 15 15 16 1 1 1 1 1 1 5 4 6 1 1 1 17 0 0 0 0 0 0 0 16 1 1 1 1 1 1 16 0 0 0 0 0 18 1 1 1 1 1 7 7 7 7 7 7 7 7 1 1 1 1 1 1 1 1 1 17 2 2 2 2 2 2 15 15 15 15 15 15 15 15 15 15 15 15 15 15 15 15 15 15 2 2 2 2 2 2 0 0 0 0 0 0 0 2 2 2 2 2 15 15 2 2 2 15 15 2 2 2 2 2 2 2 2 2 2 0 0 0 0 0 0 0 0 0 0 0 0 0 0 0 0 0 0 0 0 0 0 0 0 0 0 0 0 0 0 0 0 0 0 0 0 0 0 18 1 1 1 1 1 13 13 13 25 13 26 26 26 28 25 13 23 22 22 22 22 22 22 22 22 22 22 22 22 22 22 22 22 22 22 22 22 22 22 22 22 24 28 23 22 26 26 13 13 13 26 13 13 13 26 13 13 13 26 26 22 22 22 22 22 22 22 22 22 22 22 24 26 13 13 13 13 13 13 26 13 13 13 13 13 13 13 13 13 26 13 13 13 13 13 13 13 13 26 13 13 13 13 28 26 26 26 26 28 13 13 13 13 13 25 13 13 13 26 26 26 26 26 25 13 13 13 23 22 22 22 26 26 26 26 26 26 26 15 15 26 26 26 26 26 26 26 26 26 26 26 26 26 26 26 26 26 26 26 26 26 26 26 26 26 26 26 26 26 26 22 24 13 13 13 25 13 13 13 13 26 26 13 13 26 13 26 13 13 25 13 13 13 13 13 13 13 13 13 13 13 13 13 13 13 13 25 13 13 13 13 29 29 29 30 29 29 29 30 29 32 34 34 34 34 34 34 34 34 34 34 34 34 34 37 36 36 37 34 34 34 34 34 37 29 37 37 29 29 29 29 29 37 37 29 37
1 1 17 18 1 1 7 1 10 1 1 19 20 0 2 2 2 2 2 2 2 2 2 2 0 0 14 14 14 14 0 0 2 2 2 18 1 5 7 1 1 1 5 7 1 1 1 1 1 17 2 2 0 0 0 0 0 0 0 0 0 0 0 0 0 16 14 14 16 14 14 14 14 16 16 15 15 15 15 15 15 15 15 15 15 15 15 15 16 14 14 16 18 1 1 1 7 1 1 1 17 2 2 2 2 2 2 2 2 16 14 14 14 14 14 14 16 2 2 2 2 2 2 18 1 10 1 7 7 7 7 7 7 7 7 7 7 1 1 1 1 1 10 1 17 2 2 2 2 2 2 2 15 15 15 15 15 15 15 15 15 15 15 15 15 15 15 15 15 15 2 2 2 2 2 2 2 2 2 2 2 2 2 2 2 2 2 2 16 16 2 2 2 16 16 2 2 2 2 2 2 2 2 2 2 2 2 2 2 2 2 2 2 2 2 2 2 2 2 2 2 2 2 2 2 2 2 2 2 2 2 2 2 2 2 2 2 2 2 2 2 2 2 2 14 14 14 16 16 21 21 21 21 21 21 21 21 21 21 21 22 22 22 22 22 22 22 22 22 22 22 22 22 22 22 22 22 22 22 22 22 22 22 22 22 22 21 22 22 22 16 15 15 15 26 15 15 15 26 15 15 15 16 22 22 22 22 22 22 22 22 22 22 22 22 22 21 21 21 21 21 24 13 26 13 13 13 13 13 13 13 13 13 26 13 13 13 13 13 13 13 13 26 13 13 13 13 26 26 26 26 26 26 13 13 13 23 21 21 21 21 21 21 21 21 21 21 21 21 21 21 22 22 22 22 21 21 21 21 21 21 21 16 16 21 21 21 21 21 21 21 21 21 21 21 21 21 21 21 21 21 21 21 21 21 21 21 21 21 21 21 21 21 21 22 22 21 21 21 21 21 21 16 15 26 26 15 15 26 15 26 15 16 21 21 21 21 21 21 21 21 21 21 21 21 21 21 21 21 21 21 21 21 21 21 33 33 33 33 33 33 33 33 33 34 34 34 34 34 34 34 34 34 34 34 34 34 34 37 36 36 37 34 34 34 34 34 37 36 37 37 36 36 36 36 36 37 37 36 37
0 0 2 2 0 0 0 0 0 0 0 2 2 2 2 2 2 2 2 2 2 2 2 2 2 2 15 15 15 15 2 2 2 2 2 2 18 10 7 1 1 1 1 7 1 1 1 1 17 2 2 2 2 2 2 2 2 2 2 2 2 2 2 2 2 16 15 15 16 15 15 15 15 16 16 15 15 15 15 15 15 15 15 15 15 15 15 15 16 15 15 16 2 0 0 0 0 0 0 0 2 2 2 2 2 2 2 2 2 16 15 15 15 15 15 15 16 2 2 2 2 2 2 2 0 0 0 0 0 0 0 0 0 0 0 0 0 0 0 0 0 0 0 0 2 2 2 2 2 2 2 2 15 15 15 15 15 15 15 15 15 15 15 15 15 15 15 15 15 15 2 2 2 2 2 2 2 2 2 2 2 2 2 2 2 2 2 2 2 2 2 2 2 2 2 2 2 2 2 2 2 2 2 2 2 2 2 2 2 2 2 2 2 2 2 2 2 2 2 2 2 2 2 2 2 2 2 2 2 2 2 2 2 2 2 2 2 2 2 2 2 2 2 2 15 15 15 16 16 22 22 22 22 22 22 22 22 22 22 22 22 22 22 22 22 22 22 22 22 22 22 22 22 22 22 22 22 22 22 22 22 22 22 22 22 22 22 22 22 22 16 15 15 15 26 15 15 15 26 15 15 15 16 22 22 22 22 22 22 22 22 22 22 22 22 22 22 22 22 22 22 22 16 15 15 15 15 15 15 15 15 15 15 15 15 15 15 15 15 15 15 15 15 15 15 15 15 15 15 15 15 15 15 15 15 16 22 22 22 22 22 22 22 22 22 22 22 22 22 22 22 22 22 22 22 22 22 22 22 22 22 22 16 16 22 22 22 22 22 22 22 22 22 22 22 22 22 22 22 22 22 22 22 22 22 22 22 22 22 22 22 22 22 22 22 22 22 22 22 22 22 22 16 15 26 26 15 15 26 15 26 15 16 22 22 22 22 22 22 22 22 22 22 22 22 22 22 22 22 22 22 22 22 22 22 34 34 34 34 34 34 34 34 34 34 34 34 34 34 34 34 34 34 34 34 34 34 34 37 37 37 37 34 34 34 34 34 37 36 37 37 36 36 36 36 36 37 37 36 37
2 2 2 2 2 2 2 2 2 2 2 2 2 2 2 2 2 2 2 2 2 2 2 2 2 2 16 16 16 16 2 2 2 2 2 2 2 0 0 0 0 0 0 0 0 0 0 0 2 2 2 2 2 2 2 2 2 2 2 2 2 2 2 2 2 16 16 16 16 16 16 16 16 16 16 16 16 16 16 16 16 16 16 16 16 16 16 16 16 16 16 16 2 2 2 2 2 2 2 2 2 2 2 2 2 2 2 2 2 16 16 16 16 16 16 16 16 2 2 2 2 2 2 2 2 2 2 2 2 2 2 2 2 2 2 2 2 2 2 2 2 2 2 2 2 2 2 2 2 2 2 2 16 16 16 16 16 16 16 16 16 16 16 16 16 16 16 16 16 16 2 2 2 2 2 2 2 2 2 2 2 2 2 2 2 2 2 2 2 2 2 2 2 2 2 2 2 2 2 2 2 2 2 2 2 2 2 2 2 2 2 2 2 2 2 2 2 2 2 2 2 2 2 2 2 2 2 2 2 2 2 2 2 2 2 2 2 2 2 2 2 2 2 2 15 15 15 16 16 22 22 22 22 22 22 22 22 22 22 22 22 22 22 22 22 22 22 22 22 22 22 22 22 22 22 22 22 22 22 22 22 22 22 22 22 22 22 22 22 22 16 16 16 16 16 16 16 16 16 16 16 16 16 22 22 22 22 22 22 22 22 22 22 22 22 22 22 22 22 22 22 22 16 16 16 16 16 16 16 16 16 16 16 16 16 16 16 16 16 16 16 16 16 16 16 16 16 16 16 16 16 16 16 16 16 16 22 22 22 22 22 22 22 22 22 22 22 22 22 22 22 22 22 22 22 22 22 22 22 22 22 22 16 16 22 22 22 22 22 22 22 22 22 22 22 22 22 22 22 22 22 22 22 22 22 22 22 22 22 22 22 22 22 22 22 22 22 22 22 22 22 22 16 16 16 16 16 16 16 16 16 16 16 22 22 22 22 22 22 22 22 22 22 22 22 22 22 22 22 22 22 22 22 22 22 34 34 34 34 34 34 34 34 34 34 34 34 34 34 34 34 34 34 34 34 34 34 34 37 37 37 37 34 34 34 34 34 37 37 37 37 37 37 37 37 37 37 37 37 37