50 14
1 1 1 1 1 1 1 1 1 1 1 1 1 1 1 1 1 1 1 1 1 1 1 1 1 1 1 1 1 1 1 1 1 1 1 1 1 1 1 1 1 1 1 1 1 1 1 1 1 1
1 1 1 1 1 1 1 1 1 1 1 1 1 1 1 1 1 1 1 1 1 1 1 1 1 1 1 1 1 1 1 1 1 1 1 1 1 1 1 1 1 1 1 1 1 1 1 1 1 1
1 1 1 1 1 1 1 1 1 1 1 1 1 1 1 1 1 1 1 8 8 8 1 1 1 1 1 1 1 1 1 1 1 1 1 1 1 1 1 1 1 1 1 1 1 1 1 1 1 1
1 3 1 1 1 1 1 1 1 1 1 1 1 1 1 1 1 1 8 8 8 8 8 1 1 1 1 1 1 1 1 1 1 1 1 1 1 1 1 1 1 1 1 1 1 1 1 1 1 1
1 1 1 1 1 1 1 1 1 1 1 1 1 1 1 1 1 1 8 8 8 8 8 1 1 1 1 1 1 1 1 1 1 1 1 1 1 1 1 1 1 1 1 1 1 1 1 1 1 1
1 1 1 1 1 1 1 1 1 1 1 1 1 1 1 1 1 1 1 1 7 1 1 1 1 1 1 1 1 1 1 1 1 1 1 1 1 1 1 1 1 1 1 1 1 1 1 1 1 1
1 1 1 1 1 1 1 1 1 1 1 1 1 1 1 1 1 5 11 11 12 1 1 1 1 1 1 1 1 1 1 1 1 1 1 1 1 1 10 1 1 1 1 8 1 1 1 1 1 1
1 1 1 1 1 1 1 1 1 1 1 1 1 1 1 1 1 1 1 1 13 11 6 1 1 1 1 1 1 1 1 1 1 1 1 1 1 5 7 1 1 1 8 8 8 1 1 1 1 1
1 1 1 1 1 8 8 8 1 1 1 1 1 1 1 1 1 1 1 1 7 1 1 1 1 1 1 1 1 1 1 1 1 1 1 1 1 1 4 6 1 8 8 8 8 8 1 1 1 1
1 1 1 1 1 8 8 8 1 1 1 1 1 1 1 1 1 9 1 10 7 10 1 1 1 1 1 1 1 1 1 1 1 1 1 1 5 5 7 1 1 1 1 7 1 1 1 1 1 1
1 1 1 1 1 1 7 1 1 1 1 1 1 1 19 20 0 0 0 0 0 0 0 18 1 1 1 1 1 1 1 1 17 0 18 1 1 1 7 6 6 1 1 4 6 1 1 1 1 1
1 1 17 18 1 1 7 1 10 1 1 19 20 0 0 0 0 0 0 0 0 0 0 0 0 0 14 14 14 14 0 0 2 2 2 18 1 5 7 1 1 1 5 7 1 1 1 1 1 17
0 0 0 0 0 0 0 0 0 0 0 0 0 0 0 0 0 0 0 0 0 0 0 0 0 0 15 15 15 15 2 2 2 2 2 2 18 10 7 1 1 1 1 7 1 1 1 1 17 2
2 2 2 2 2 2 2 2 2 2 2 2 2 2 2 2 2 2 2 2 2 2 2 2 2 2 16 16 16 16 2 2 2 2 2 2 2 0 0 0 0 0 0 0 0 0 0 0 2 2